NO      ./path_to_the_north_texture
SO      ./path_to_the_south_texture
C 225,30,dffsddf
WE ./path_to_the_west_texture
EA ./path_to_the_east_texture
F  220,100,0











           1111111111111111111111111
           1000000000110000000000001
           10110000011 1110000000000001
           10010000001 1000000000000001
1111111110110000011101 1000000000001
1000000000110000011101 1111111111101
11110111111111011100001010001
11110111111111011101010010001
11000000110101011100000010001
1
1
10000000000000001100000010001
10000000000000001101010010001
11000001110101011111011110N0111
11110111 1110101 101111010001
11111111 1111111 111111111111

