



               NO images/walls_xmp/no_20.xpm  
        SO             images/walls_xmp/so.xpm
WE       images/walls_xmp/we.xpm
               EA                      images/walls_xmp/ea.xpm 




   C    0, 10,     200
              
                                                                F    255,102, 102    

                

        111111111111111111111111111
        1011         11100000000001          
        10011       101000000000001
111111111111       1010000000000001
100000000011     110111000000001111
11110111111    11100000000001000001
111101         11101010010001011111
11S001111111111111100000010001
10000000000000001100000010101
10000000000000000000000010101
10000100000000000000000000101
10000000000000000000000000101
10000000100000111111100000101
100000001000001     100010101
100000001000001     100010101
100000001000001     100010101
10000011111100111111100010101
10000000000000000000000010101
10000000000000000000000010101
10000000000000001100000010101
10000000010000001100000010101
10000000000000001100000010101
10000111111110001100000010001
10000000000000000110011110001
1000001111110000110001  10001
1000001    10000110001  10001
1000001    10000110001  10001
1000001    100001100011110001
10000011111100110000000101001
10000000000000001100000010101
10000000000000001101010011011
11000001110101011111011111111
1110111 1110101 101111010011
   1       1 1  1111111 1111111 



