



               NO images/path_to_the_north_texture.xpm  
        SO             images/path_to_the_south_texture.xpm
WE       images/path_to_the_west_texture.xpm
               EA                      images/path_to_the_east_textures.xpm



   F    250,  100   ,0
   C    225,   30,    6

                

                      
                       1111111111111111111111                 
                       100000000011000000000011111
                       10110000011 1110000000000001         
                       10010000001 100000000000001
            1111111111110000011101 100000000000111
            10000000001100000110111111111111101
            11110111111111011100001010001111111
            11110111111111011101010010001
            11000000110101011100000010001
            11111111111111111111111111111
            1
            11111111111111111111111111111
            10000000000000001100000010101
            10000000000000001101010011N11
            110000011101010111110111111111
            1110111 1110101 101111010011
               1       1 1  1111111 1111111 11111111111
             





