



               NO images/walls_xmp/1.xpm  
        SO             images/walls_xmp/2.xpm
WE       images/walls_xmp/3.xpm
               EA                      images/walls_xmp/4.xpm 



   C    255, 153, 153
   F    74, 255, 164

                

                  
        1111111111111111111111         
        100000000011000000000011111
        10110000011 1110000000000001          
        10010000001 101000000000001
1111111111110000011101 1000000000001
100000000011000001101111000000011101
11110111111111011100001010001111111
11110111111111011101010010001
11000000110101011100000010001
10000000000000001100000010101
10000000000000000000000010101
10000000000000000000000000101
10000000000000000000000000101
10000000100000000000000000101
10000000100000000000000010101
10000000100000000000000010101
10000000100000000000000010101
10000011111100000000000010101
10000000000000000000000010101
10000000000000000000000010101
10000000000000001100000010101
10000000000000001100000010101
10000000000000001100000010101
10000111111110001100000010001
10000000000000001100000010001
10000000000000001100000010001
10000000000000001100000010001
10000000000000001100000010001
10000000000000001100000010001
10000000N00000001100000010101
10000000000000001100000010101
10000000000000001101010011011
110000011101010111110111111111
1110111 1110101 101111010011
   1       1 1  1111111 1111111 
             





