



               NO images/walls_xmp/1.xpm  
        SO             images/walls_xmp/2.xpm
WE       images/walls_xmp/3.xpm
               EA                      images/walls_xmp/4.xpm 




   C    102, 102, 255
              
                                                                F    255,102, 102    

                

                  
1111111111111111111111111111111111111111111111111111111111111       
10000000000000000011000000000011100000000000000000001110000011111111
1001000000110000011 1110000000111000000000000000000011100000111000001          
1000000000010000001 101000000011100000000000000000001110000011100001
1111111111110000011101 100000011100000000000000000001110000011100001111111111
10000000001100000110001000000000000000000001000000000000000000000111100000001111
11110111111111011100000000000000000000000001000000000000000000000001010001111111
11110111111111011101000000000000000000000001000000000000000000000010010001011111
110000001101010111000000000000000000000000010000000000000000000000000100011
10000000000000001100000000000000000000000001000000000000000000000000010101
10000000000000000000000000000000000000000001000000000000000000000000010101
1000000000S000000000000000000000000000000000000000000000000000000000000101
10000000000000000000000000000000000000000000000000000000000000000000000101
10000000100000000000000000000000000000000000000000000000000000000000000101
10000000100000000000000000000000000000000000000000000000000000000000010101
10000000100000000000000000000000000000000000000000000000000000000000010101
10000000100000000000000000000000000000000000000000000000000000000000010101
10000000100000000000000000000000000000000000000000000000000000000000010101
10000000000000000000000000000000000000000000000000000000000000000000010101
10000000000000000000000000000000000000000001000000000000000000000000010101
10000000000000000000000000000000000000000001000000000000000000000000010101
10000000000000000000000000000000000000000001000000000000000000000000010101
10000000000000000000000000000000000000000001000000000000000000000000010101
10000000000000000000000000000000000000000001000000000000000000000000010101
10000000100000000000000000000000000000000001000000000000000000000000010101
10000000100000000000000000000000000000000001000000000000000000000000010101
10000011111100000000000000000000000000000001000000000000000000000000010101
10000011111100000000000000000000000000000001000000000000000000000000010101
10000000000000000000000000000000000000000001000000000000000000000000010101
10000000000000000000000000000000000000000001000000000000000000000000010101
10000000000000001100000000000000000000000001000000000000000000000000010101
10000000010000001100000000000000000000000001000000000000000000000000010101
10000000000000001100000000000000000000000001000000000000000000000000010101
10000111111110001100000000000000000000000001000000000000000000000000010001
10000000000000000110000000000000000000000001000000000000000000000000010001
10000000000000001100000000000000000000000001000000000000000000000000010001
10000000000000001100000000000000000000000001000000000000000000000000010001
10000000000000001100000000000000000000000001000000000000000000000000010001
10000000000000001100000000000000000000000001000000000000000000000000010001
1000000000000011000000000000000000000000000100000000000000000000000010101
10000000000000001100000000000000000000000001000000000000000000000000010101
10000000000000001101000000000000000000000001000000000000000000000010011011
110000011101010111110000000000000000000000010000000000000000000000111111111
1110111 1110101 1011110100111111111111111111111111111111111111111111
   1       1 1  1111111 1111111 
             





