



               NO utils/texturs/no.xpm  
        SO             utils/texturs/so.xpm
WE       utils/texturs/we.xpm
               EA                      utils/texturs/ea.xpm



                                                                F    255,102, 102    

   C    0, 10,     200
              

                

        111111111111111111111111111
        1011         11100000000001          
        10011       100000000000001
111111111111       1000000000000001
100000000011     110011000000001111
11110111111    11100000000001000001
111101         11101010010000011111
11S001111111111111000000000001
10000000000000001100000010101
10000000000000000000000010101
10000100000000000000000000101
10000000000000000000000000101
10000000100000111111100000101
100000001000001     100010101
100000001000001     100010101
100000001000001     100010101
10000011111100111111100010101
10000000000000000000000010101
10000000000000000000000010101
10000000000000001100000010101
10000000010000001100000010101
10000000000000001100000010101
10000111111110001100000010001
10000000000000000110011110001
1000001111110000110001  10001
1000001    10000110001  10001
1000001    10000110001  10001
1000001    100001100011110001
10000011111100111000000100001
10000000000000000000000000001
10000000000000001100010011011
1100000111000101111011111111111
111011111110000011101111010011
11111111111111111111111111111 



